R 110 110
SO ./textures/so.xpm
WE ./textures/puple.xpm
EA ./textures/greystone.xpm
S  ./textures/tt.xpm
NO ./textures/no.xpm


F  110,110,110
C 128,123,25

 111111111
10000W2021
1222200011
1000000011
1000000011
1000000011
1000000011
1000000011
1000000011
1000000011
1000000011
1000000011
1000000011
1000000011
1000000011
1000000011
1000000011
1000000011
1000000011
1000000011
111111111
 1
